NO ./texture/nass_elghiwane.xpm
SO ./texture/nass_elghiwane.xpm
EA ./texture/nass_elghiwane.xpm
WE ./texture/nass_elghiwane.xpm
C 225,0,0
F 255,200,0

11111111111111111111111111111111111111111111111111111111111111111111111111111111111111111111111111111111111111111111111111111111111111111111111111111111111111111111111111111111111111111111111111
10001000000010100000001000010001000000100010000100001000000010100000001000010001000000100010000100001000000010100000001000010001000000100010000100001000000010100000001000010001000000100010000101
10100010010010011010000001000000100110101000100100100010010010011010000001000000100110101000100100100010010010011010000001000000100110101000100100100010010010011010000001000000100110101000100101
10011100000010000100111011100100101000100101000100011100000010000100111011100100101000100101000100011100000010000100111011100100101000100101000100011100000010000100111011100100101000100101000101
10100010011000100001000001001001010010000100010100100010011000100001000001001001010010000100010100100010011000100001000001001001010010000100010100100010011000100001000001001001010010000100010101
11001000100001001000011100010000001001001111000101001000100001001000011100010000001001001111000101001000100001001000011100010000001001001111000101001000100001001000011100010000001001001111000101
10000111011010011111100011001000001001010100100100000111011010011111100011001000001001010100100100000111011010011111100011001000001001010100100100000111011010011111100011001000001001010100100101
10101000000000001000001000100010000001010000100000101000000000001000001000100010000001010000100000101000000000001000001000100010000001010000100000101000000000001000001000100010000001010000100001
10010010010011001010010010100010100101001010101010010010010011001010010010100010100101001010101010010010010011001010010010100010100101001010101010010010010011001010010010100010100101001010101011
10000000100100010011000100101000010101101010001000000000100100010011000100101000010101101010001000000000100100010011000100101000010101101010001000000000100100010011000100101000010101101010001001
10100011001000010100100101001111001000001001010000100011001000010100100101001111001000001001010000100011001000010100100101001111001000001001010000100011001000010100100101001111001000001001010001
10100100100111000100000101000000100010000100000000100100100111000100000101000000100010000100000000100100100111000100000101000000100010000100000000100100100111000100000101000000100010000100000001
10010100010000100001110001011110010000010010101000010100010000100001110001011110010000010010101000010100010000100001110001011110010000010010101000010100010000100001110001011110010000010010101001
10001001011110010010000000100000010111010010100100001001011110010010000000100000010111010010100100001001011110010010000000100000010111010010100100001001011110010010000000100000010111010010100101
11110001000001001000101001001000010000001000110001110001000001001E00101001001000010000001000110001110001000001001000101001001000010000001000110001110001000001001000101001001000010000001000110001
10000110011100001000100110010011001010101010001000000110011100001000100110010011001010101010001000000110011100001000100110010011001010101010001000000110011100001000100110010011001010101010001001
10100000100010110000010000001000100010100101001000100000100010110000010000001000100010100101001000100000100010110000010000001000100010100101001000100000100010110000010000001000100010100101001001
10011001001011000000101110010000010100110000101010011001001011000000101110010000010100110000101010011001001011000000101110010000010100110000101010011001001011000000101110010000010100110000101011
11000100101000011110100001100100100010001010001001000100101000011110100001100100100010001010001001000100101000011110100001100100100010001010001001000100101000011110100001100100100010001010001001
10110010100111000000101010000001000010101001110100110010100111000000101010000001000010101001110100110010100111000000101010000001000010101001110100110010100111000000101010000001000010101001110101
10001001001000010100100100100101000100100010000100001001001000010100100100100101000100100010000100001001001000010100100100100101000100100010000100001001001000010100100100100101000100100010000101
11000101010010001000001001011000010100010010011001000101010010001000001001011000010100010010011001000101010010001000001001011000010100010010011001000101010010001000001001011000010100010010011001
10001001010100100001000100000111100101010000100000001001010100100001000100000111100101010000100000001001010100100001000100000111100101010000100000001001010100100001000100000111100101010000100001
10110010010110100010010001100000000101001100101000110010010110100010010001100000000101001100101000110010010110100010010001100000000101001100101000110010010110100010010001100000000101001100101001
10000010100001001010011100010001001000100000100100000010100001001010011100010001001000100000100100000010100001001010011100010001001000100000100100000010100001001010011100010001001000100000100101
10011100100101010010100011100001110000001100110010011100100101010010100011100001110000001100110010011100100101010010100011100001110000001100110010011100100101010010100011100001110000001100110011
10000001001001010010001000011110000101110001001000000001001001010010001000011110000101110001001000000001001001010010001000011110000101110001001000000001001001010010001000011110000101110001001001
10101000001001000001000011000000010000000100000100101000001001000001000011000000010000000100000100101000001001000001000011000000010000000100000100101000001001000001000011000000010000000100000101
10010001000100100101000100111001000010011010011000010001000100100101000100111001000010011010011000010001000100100101000100111001000010011010011000010001000100100101000100111001000010011010011001
10000101010010111001011001000001010000000000100000000101010010111001011001000001010000000000100000000101010010111001011001000001010000000000100000000101010010111001011001000001010000000000100001
10100010010010000000100001010100001000111001001000100010010010000000100001010100001000111001001000100010010010000000100001010100001000111001001000100010010010000000100001010100001000111001001001
10100100101000100100101010010010110001000110001110100100101000100100101010010010110001000110001110100100101000100100101010010010110001000110001110100100101000100100101010010010110001000110001111
10100010000111001000001000001010000010010000110000100010000111001000001000001010000010010000110000100010000111001000001000001010000010010000110000100010000111001000001000001010000010010000110001
10111001110000010011010101101010010100010001000100111001110000010011010101101010010100010001000100111001110000010011010101101010010100010001000100111001110000010011010101101010010100010001000101
10000010001101101000000010010010001001101101000100000010001101101000000010010010001001101101000100000010001101101000000010010010001001101101000100000010001101101000000010010010001001101101000101
11111000100010001001101000000001100100000010001001111000100010001001101000000001100100000010001001111000100010001001101000000001100100000010001001111000100010001001101000000001100100000010001001
10000000001001000010000110010010010010001010010000000000001001000010000110010010010010001010010000000000001001000010000110010010010010001010010000000000001001000010000110010010010010001010010001
10000111000100100100010001001010001011010000010100000111000100100100010001001010001011010000010100000111000100100100010001001010001011010000010100000111000100100100010001001010001011010000010101
10011000010010110010001000100100010000100100100100011000010010110010001000100100010000100100100100011000010010110010001000100100010000100100100100011000010010110010001000100100010000100100100101
10100011100100001010100010001001011001000010000100100011100100001010100010001001011001000010000100100011100100001010100010001001011001000010000100100011100100001010100010001001011001000010000101
10100100010000100010011001010010000010001001010000100100010000100010011001010010000010001001010000100100010000100010011001010010000010001001010000100100010000100010011001010010000010001001010001
11000101010111010111000100010100100010100101001001000101010111010111000100010100100010100101001001000101010111010111000100010100100010100101001001000101010111010111000100010100100010100101001001
10010001011000010010010100100100010100010001001000010001011000010010010100100100010100010001001000010001011000010010010100100100010100010001001000010001011000010010010100100100010100010001001001
10001010000010010010010110001001100000100100100110001010000010010010010110001001100000100100100110001010000010010010010110001001100000100100100110001010000010010010010110001001100000100100100111
10101000011000100100100000111100011111000010010000101000011000100100100000111100011111000010010000101000011000100100100000111100011111000010010000101000011000100100100000111100011111000010010001
10010110100101001000000101001001000000001000010100010110100101001000000101001001000000001000010100010110100101001000000101001001000000001000010100010110100101001000000101001001000000001000010101
10000000000100001001110001010010010111011111001000000000000100001001110001010010010111011111001000000000000100001001110001010010010111011111001000000000000100001001110001010010010111011111001001
10100101100110000110001010001000001000001000010000100101100110000110001010001000001000001000010000100101100110000110001010001000001000001000010000100101100110000110001010001000001000001000010001
10000100000001000000100010100000000000100010000100000100000001000000100010100000000000100010000100000100000001000000100010100000000000100010000100000100000001000000100010100000000000100010000101
10001000000010100000001000010001000000100010000100001000000010100000001000010001000000100010000100001000000010100000001000010001000000100010000100001000000010100000001000010001000000100010000101
10100010010010011010000001000000100110101000100100100010010010011010000001000000100110101000100100100010010010011010000001000000100110101000100100100010010010011010000001000000100110101000100101
10011100000010000100111011100100101000100101000100011100000010000100111011100100101000100101000100011100000010000100111011100100101000100101000100011100000010000100111011100100101000100101000101
10100010011000100001000001001001010010000100010100100010011000100001000001001001010010000100010100100010011000100001000001001001010010000100010100100010011000100001000001001001010010000100010101
11001000100001001000011100010000001001001111000101001000100001001000011100010000001001001111000101001000100001001000011100010000001001001111000101001000100001001000011100010000001001001111000101
10000111011010011111100011001000001001010100100100000111011010011111100011001000001001010100100100000111011010011111100011001000001001010100100100000111011010011111100011001000001001010100100101
10101000000000001000001000100010000001010000100000101000000000001000001000100010000001010000100000101000000000001000001000100010000001010000100000101000000000001000001000100010000001010000100001
10010010010011001010010010100010100101001010101010010010010011001010010010100010100101001010101010010010010011001010010010100010100101001010101010010010010011001010010010100010100101001010101011
10000000100100010011000100101000010101101010001000000000100100010011000100101000010101101010001000000000100100010011000100101000010101101010001000000000100100010011000100101000010101101010001001
10100011001000010100100101001111001000001001010000100011001000010100100101001111001000001001010000100011001000010100100101001111001000001001010000100011001000010100100101001111001000001001010001
10100100100111000100000101000000100010000100000000100100100111000100000101000000100010000100000000100100100111000100000101000000100010000100000000100100100111000100000101000000100010000100000001
10010100010000100001110001011110010000010010101000010100010000100001110001011110010000010010101000010100010000100001110001011110010000010010101000010100010000100001110001011110010000010010101001
10001001011110010010000000100000010111010010100100001001011110010010000000100000010111010010100100001001011110010010000000100000010111010010100100001001011110010010000000100000010111010010100101
11110001000001001000101001001000010000001000110001110001000001001000101001001000010000001000110001110001000001001000101001001000010000001000110001110001000001001000101001001000010000001000110001
10000110011100001000100110010011001010101010001000000110011100001000100110010011001010101010001000000110011100001000100110010011001010101010001000000110011100001000100110010011001010101010001001
10100000100010110000010000001000100010100101001000100000100010110000010000001000100010100101001000100000100010110000010000001000100010100101001000100000100010110000010000001000100010100101001001
10011001001011000000101110010000010100110000101010011001001011000000101110010000010100110000101010011001001011000000101110010000010100110000101010011001001011000000101110010000010100110000101011
11000100101000011110100001100100100010001010001001000100101000011110100001100100100010001010001001000100101000011110100001100100100010001010001001000100101000011110100001100100100010001010001001
10110010100111000000101010000001000010101001110100110010100111000000101010000001000010101001110100110010100111000000101010000001000010101001110100110010100111000000101010000001000010101001110101
10001001001000010100100100100101000100100010000100001001001000010100100100100101000100100010000100001001001000010100100100100101000100100010000100001001001000010100100100100101000100100010000101
11000101010010001000001001011000010100010010011001000101010010001000001001011000010100010010011001000101010010001000001001011000010100010010011001000101010010001000001001011000010100010010011001
10001001010100100001000100000111100101010000100000001001010100100001000100000111100101010000100000001001010100100001000100000111100101010000100000001001010100100001000100000111100101010000100001
10110010010110100010010001100000000101001100101000110010010110100010010001100000000101001100101000110010010110100010010001100000000101001100101000110010010110100010010001100000000101001100101001
10000010100001001010011100010001001000100000100100000010100001001010011100010001001000100000100100000010100001001010011100010001001000100000100100000010100001001010011100010001001000100000100101
10011100100101010010100011100001110000001100110010011100100101010010100011100001110000001100110010011100100101010010100011100001110000001100110010011100100101010010100011100001110000001100110011
10000001001001010010001000011110000101110001001000000001001001010010001000011110000101110001001000000001001001010010001000011110000101110001001000000001001001010010001000011110000101110001001001
10101000001001000001000011000000010000000100000100101000001001000001000011000000010000000100000100101000001001000001000011000000010000000100000100101000001001000001000011000000010000000100000101
10010001000100100101000100111001000010011010011000010001000100100101000100111001000010011010011000010001000100100101000100111001000010011010011000010001000100100101000100111001000010011010011001
10000101010010111001011001000001010000000000100000000101010010111001011001000001010000000000100000000101010010111001011001000001010000000000100000000101010010111001011001000001010000000000100001
10100010010010000000100001010100001000111001001000100010010010000000100001010100001000111001001000100010010010000000100001010100001000111001001000100010010010000000100001010100001000111001001001
10100100101000100100101010010010110001000110001110100100101000100100101010010010110001000110001110100100101000100100101010010010110001000110001110100100101000100100101010010010110001000110001111
10100010000111001000001000001010000010010000110000100010000111001000001000001010000010010000110000100010000111001000001000001010000010010000110000100010000111001000001000001010000010010000110001
10111001110000010011010101101010010100010001000100111001110000010011010101101010010100010001000100111001110000010011010101101010010100010001000100111001110000010011010101101010010100010001000101
10000010001101101000000010010010001001101101000100000010001101101000000010010010001001101101000100000010001101101000000010010010001001101101000100000010001101101000000010010010001001101101000101
11111000100010001001101000000001100100000010001001111000100010001001101000000001100100000010001001111000100010001001101000000001100100000010001001111000100010001001101000000001100100000010001001
10000000001001000010000110010010010010001010010000000000001001000010000110010010010010001010010000000000001001000010000110010010010010001010010000000000001001000010000110010010010010001010010001
10000111000100100100010001001010001011010000010100000111000100100100010001001010001011010000010100000111000100100100010001001010001011010000010100000111000100100100010001001010001011010000010101
10011000010010110010001000100100010000100100100100011000010010110010001000100100010000100100100100011000010010110010001000100100010000100100100100011000010010110010001000100100010000100100100101
10100011100100001010100010001001011001000010000100100011100100001010100010001001011001000010000100100011100100001010100010001001011001000010000100100011100100001010100010001001011001000010000101
10100100010000100010011001010010000010001001010000100100010000100010011001010010000010001001010000100100010000100010011001010010000010001001010000100100010000100010011001010010000010001001010001
11000101010111010111000100010100100010100101001001000101010111010111000100010100100010100101001001000101010111010111000100010100100010100101001001000101010111010111000100010100100010100101001001
10010001011000010010010100100100010100010001001000010001011000010010010100100100010100010001001000010001011000010010010100100100010100010001001000010001011000010010010100100100010100010001001001
10001010000010010010010110001001100000100100100110001010000010010010010110001001100000100100100110001010000010010010010110001001100000100100100110001010000010010010010110001001100000100100100111
10101000011000100100100000111100011111000010010000101000011000100100100000111100011111000010010000101000011000100100100000111100011111000010010000101000011000100100100000111100011111000010010001
10010110100101001000000101001001000000001000010100010110100101001000000101001001000000001000010100010110100101001000000101001001000000001000010100010110100101001000000101001001000000001000010101
10000000000100001001110001010010010111011111001000000000000100001001110001010010010111011111001000000000000100001001110001010010010111011111001000000000000100001001110001010010010111011111001001
10100101100110000110001010001000001000001000010000100101100110000110001010001000001000001000010000100101100110000110001010001000001000001000010000100101100110000110001010001000001000001000010001
10000100000001000000100010100000000000100010000100000100000001000000100010100000000000100010000100000100000001000000100010100000000000100010000100000100000001000000100010100000000000100010000101
11111111111111111111111111111111111111111111111111111111111111111111111111111111111111111111111111111111111111111111111111111111111111111111111111111111111111111111111111111111111111111111111111

