NO ./texture/nass_elghiwane.xpm
 
SO ./texture/pink_floyd.xpm
  
WE ./texture/james.xpm



F 25,255,255
C 25,255,255

EA ./texture/nass_elghiwane.xpm

1111111111111111111111111111111111111111
1000000000000000000000000000000000000001
1000000000000000100000000W0000000000001
100000000000000000000000000000000000001
1111111111111111111111111111111111111111