NO ./texture/nass_elghiwane.xpm

SO ./texture/pink_floyd.xpm
  
WE ./texture/james.xpm

EA ./texture/nass_elghiwane.xpm
F 220 ,  200    ,0                  
C 225,0   ,0        



        1111111111111111111111111
        1E00000000110000000000001
        1011000001110000000000001
        1001000000000000000000001
111111111011000001110000000000001
100000000011000001110111111111111
111101111111110111000000100011111111111111111111111111111111111111111111111111111
111101111111110111010100000000000000000000000000000000000000000000000000000000001
1100000011010101110000001000111111111111111111111111111111111111111111111111111111
10000000000000001100000010001
10000000000000001101010010001
1100000111010101111101111000111
11110111 1110101  101111010001             
11111111 1111111  111111111111




