

 
NO ./textures/red_wall.xpm
    
   
   
                 SO ./textures/green_wall.xpm
    
    
    
WE ./textures/blue_wall.xpm
     
     
   
  
EA ./textures/yellow_wall.xpm
  
  
 
 
 
 
 
F 51,51,51
        
 
 
C 173, 216, 230
 
11111111111111111111111111111111
10000000000000000000000000000001
10100000000000000000010000000001
11000000010000000000000000000001
10001000010000110000101111111111111111111111111
10001000000000110000000000000011
100010000000000100N0010010000001
10000000000000000000000001000001
11111111111111111111111111111111     
     