NO ./texture/nass_elghiwane.xpm
 
SO ./texture/pink_floyd.xpm
  
WE ./texture/james.xpm
EA ./texture/nass_elghiwane.xpm



F 220, 200    ,0               


C                      125,0   ,0
111111
10E1
1111