

 
NO ./textures/red_wall.xpm
    
   
   
                 SO ./textures/green_wall.xpm
    
    
    
WE ./textures/blue_wall.xpm

   
  
EA ./textures/yellow_wall.xpm
  
  
 
 
 
 
 
F 51,51,51
        

 
C 173, 216, 230
  
11111111111111111111111111111111
10000000000000000000000000000001
10100000000000000000010000000001
1100000001000000000000000000000111
100010000100001100001011111111111111
1000100000000011N00000000000001111
100010000000000100N00100   10000001
10000000000000000000000001000001
11111111111111111111111111111111
  
   11
 
 
         
 